00000000000000000000
01111111111111111110
01111111111111111110
01111111111111111110
01111111111111111110
01111111122211111110
01111111121111111110
01111111121211111110
01112222221211111110
01112211111211111110
01112222222211111110
01111111111111111110
01111111111111111110
01111111111111111110
01111111111111111110
01111111111111111110
01111111112221111110
01111111112221111110
01111111112221111110
01111111111111111110
01111111111111111110
01111111111111111110
01111111111111122220
01111111111111122120
01111111111111122220
01111111111111112220
07771111111222222220
07771111111211222120
07771111111222222220
00000000000000000000
01111111111111111110
10001000100000000001
10001000100000000001
10001000100000000001
10000000111111111111
10000000100000000001
10000000100000000001
11111111100000000001
10000000000011111111
10000000000010000001
10000000000010000001
10001111111111111111
10001000000000000001
10001000000000000001
11111000000000000001
10001111111111110001
10001000110000000001
10001000110000000001
10000000110000000001
10000000110001111111
10000000110001000001
11111111110001111111
10000000010001100001
10000000010001100101
10000000010001100001
10001100011111110001
70007100011000000001
76667100011011000101
76667100011000000001
07771111111111111110
01111111111111111110
10001000100000000001
10001000100000000001
10001000100000000001
10000000111111111111
10000000100000000001
10000000100000000001
11111111100000000001
10000000000011111111
10000000000010000001
10000000000010000001
10001111111111111111
10001000000000000001
10001000000000000001
11111000000000000001
10001111111111110001
10001000110000000001
10001000110000000001
10000000110000000001
10000000110001111111
10000000110001000001
11111111110001111111
10000000010000101111
10000000010000101111
10000000010000101111
10001100011111110001
70007100001000001111
76667100001011001110
76667100001000001111
07771111111111111110
01111111111111111110
10001000000000100001
10001000000000100001
10001000000000100001
10000000111111110001
10000000100000010001
10000000100000010001
11111111100000010001
10000000000011111111
10000000000010000001
10000000000010000001
10001111111111111111
10001000000000000001
10001000000000000001
10001000000000000001
10001000111111110001
10001000110000000001
11111000110000000001
10000000110000000001
10000000110001111111
10000000110001000001
11111111110001111111
10000000010000000001
10000000010000000001
10000000010000000001
10001100011111110001
70007100000000000001
76667100000000000001
76667100000000000001
07771111111111111110
01111111111111111110
10001000000000100001
10001000000000100001
10001000000000100001
10000000111111110001
10000000100000010001
10000000100000010001
11111111100000010001
10000000000011111111
10000000000010000001
10000000000010000001
10001111111111111111
10001000000000000001
10001000000000000001
10001000000000000001
10001000111111110001
10001000110000000001
11111000110000000001
10000000110000000001
10000000110001111111
10000000110001000001
11111111110001111111
10000000010000000001
10000000010000000001
10000000010000000001
10001100011111110001
70007100000000000001
76667100000000000001
76667100000000000001
07771111111111111110
00000000000000000000
01110111111111111110
01110111111111111110
01110111111111111110
01111111000000001110
01111111022211111110
01111111022211111110
00000000022211111110
01111111111200000000
02222222221200000000
02222222222200000000
01110000000000000000
01110111111111111110
01110111111111111110
01110111111111111110
01110111000000001110
01110111001111111110
01110111001111111110
01111111001111111110
01111111001110000000
01111111001110000000
00000000001111111110
01111111101110000001
01111111101110000001
01111111101110000001
01110011111111110001
07770100000000000001
07770100000000000001
07770100000000000001
00000011111111111110
00000000000000000000
00000000000000000000
00000000000000000000
00000000000000000000
00000000000000000000
00000000000000000000
00000000000000000000
00000000000000000000
00000000000000000000
00000000000000000000
00000000000000000000
00000000000000000000
00000000000000000000
00000000000000000000
00000000000000000000
00000000000000000000
00000000000000000000
00000000000000000000
00000000000000000000
00000000000000000000
00000000000000000000
00000000000000000000
00000000000002222220
00000000000002222220
00000000000002222220
00000000000000002220
00000022222222222220
00000022222222222220
00000022222222222220
00000000000000000000
00000000000000000000
00000000000000000000
00000000000000000000
00000000000000000000
00000000000000000000
00000000000000000000
00000000000000000000
00000000000000000000
00000000000000000000
00000000000000000000
00000000000000000000
00000000000000000000
00000000000000000000
00000000000000000000
00000000000000000000
00000000000000000000
00000000000000000000
00000000000000000000
00000000000000000000
00000000000000000000
00000000000000000000
00000000000000000000
00000000000000000000
00000000000000000000
00000000000000000000
00000000000000000000
00000000000000000000
00000000000000000000
00000000000000000000
00000000000000000000
00000000000000000000
00000000000000000000
00000000000000000000
00000000000000000000
00000000000000000000
00000000000000000000
00000000000000000000
00000000000000000000
00000000000000000000
00000000000000000000
00000000000000000000
00000000000000000000
00000000000000000000
00000000000000000000
00000000000000000000
00000000000000000000
00000000000000000000
00000000000000000000
00000000000000000000
00000000000000000000
00000000000000000000
00000000000000000000
00000000000000000000
00000000000000000000
00000000000000000000
00000000000000000000
00000000000000000000
00000000000000000000
00000000000000000000
00000000000000000000