00000000000000000000
00000001111110000000
00000001111110000000
00000001111110000000
00000001111110000000
00000002221110000000
00000002221110000000
00000002221110000000
00000002221110000000
00000002221110000000
00000002221110000000
00000002221110000000
00000002221110000000
00000002221110000000
00000002221110000000
00000002221110000000
00000002221110000000
00000002221110000000
00000002221110000000
00000001111110000000
00000001111110000000
00000001111110000000
00000001111110000000
00000001111110000000
00000001111110000000
00000001111110000000
00000001111110000000
00000007777770000000
00000007777770000000
00000000000000000000
00000001111110000000
00000010000001000000
00000010000001000000
00000010000001000000
00000010000001000000
00000010001111000000
00000010000001000000
00000010000001000000
00000010001001000000
00000010001001000000
00000010001001000000
00000010001001000000
00000010001001000000
00000010001001000000
00000010001001000000
00000010001001000000
00000010001001000000
00000010001001000000
00000010001001000000
00000010001001000000
00000011111001000000
00000010000001000000
00000010000001000000
00000010000001000000
00000010000001000000
00000010000001000000
00000010000001000000
00000070000007000000
00000076000007000000
00000007777770000000
00000001111110000000
00000010000001000000
00000010000001000000
00000010000001000000
00000010000001000000
00000010001111000000
00000010000001000000
00000010000001000000
00000010001001000000
00000010001001000000
00000010001001000000
00000010001001000000
00000010001001000000
00000010001001000000
00000010001001000000
00000010001001000000
00000010001001000000
00000010001001000000
00000010001001000000
00000010001001000000
00000011111001000000
00000010000001000000
00000010000001000000
00000010000001000000
00000010000001000000
00000010000001000000
00000010000001000000
00000070000007000000
00000070000007000000
00000007777770000000
00000001111110000000
00000010000001000000
00000010000001000000
00000010000001000000
00000010000001000000
00000010001111000000
00000010000001000000
00000010000001000000
00000010001001000000
00000010001001000000
00000010001001000000
00000010001001000000
00000010001001000000
00000010001001000000
00000010001001000000
00000010001001000000
00000010001001000000
00000010001001000000
00000010001001000000
00000010001001000000
00000011111001000000
00000010000001000000
00000010000001000000
00000010000001000000
00000010000001000000
00000010000001000000
00000010000001000000
00000070000007000000
00000070000007000000
00000007777770000000
00000001111110000000
00000010000001000000
00000010000001000000
00000010000001000000
00000010000001000000
00000010001111000000
00000010001001000000
00000010001001000000
00000010001001000000
00000010001001000000
00000010001001000000
00000010001001000000
00000010001001000000
00000010001001000000
00000010001001000000
00000010001001000000
00000010001001000000
00000010001001000000
00000010001001000000
00000010001001000000
00000011111001000000
00000010000001000000
00000010000001000000
00000010000001000000
00000010000001000000
00000010000001000000
00000010000001000000
00000070000007000000
00000070000007000000
00000007777770000000
00000001111110000000
00000010000001000000
00000010000001000000
00000010000001000000
00000010000001000000
00000010001111000000
00000010001001000000
00000010001001000000
00000010001001000000
00000010001001000000
00000010001001000000
00000010001001000000
00000010001001000000
00000010001001000000
00000010001001000000
00000010001001000000
00000010001001000000
00000010001001000000
00000010001001000000
00000010001001000000
00000011111001000000
00000010000001000000
00000010000001000000
00000010000001000000
00000010000001000000
00000010000001000000
00000010000001000000
00000070000007000000
00000070000007000000
00000007777770000000
00000001111110000000
00000010000001000000
00000010000001000000
00000010000001000000
00000010000001000000
00000010001111000000
00000010001001000000
00000010001001000000
00000010001001000000
00000010001001000000
00000010001001000000
00000010001001000000
00000010001001000000
00000010001001000000
00000010001001000000
00000010001001000000
00000010001001000000
00000010001001000000
00000010001001000000
00000010001001000000
00000011111001000000
00000010000001000000
00000010000001000000
00000010000001000000
00000010000001000000
00000010000001000000
00000010000001000000
00000070000007000000
00000070000007000000
00000007777770000000
00000001111110000000
00000010000001000000
00000010000001000000
00000010000001000000
00000010000001000000
00000013331111000000
00000013331001000000
00000013331001000000
00000013331001000000
00000013331001000000
00000013331001000000
00000013331001000000
00000013331001000000
00000013331001000000
00000013331001000000
00000013331001000000
00000013331001000000
00000013331001000000
00000013331001000000
00000010001001000000
00000011111001000000
00000010000001000000
00000010000001000000
00000010000001000000
00000010000001000000
00000010000001000000
00000010000001000000
00000070000007000000
00000070000007000000
00000007777770000000
00000000000000000000
00000001111110000000
00000001111110000000
00000001111110000000
00000001111110000000
00000001111110000000
00000001111110000000
00000001111110000000
00000001111110000000
00000001111110000000
00000001111110000000
00000001111110000000
00000001111110000000
00000001111110000000
00000001111110000000
00000001111110000000
00000001111110000000
00000001111110000000
00000001111110000000
00000001111110000000
00000001111110000000
00000001111110000000
00000001111110000000
00000001111110000000
00000001111110000000
00000001111110000000
00000001111110000000
00000007777770000000
00000007777770000000
00000000000000000000
